                                                  # # # # # # # # # # # # # # # # # # # # # # # # #                 # # # # # # # # # # # # # # # # # # #
                                                  # . . . . . . . . . . . . . . . . . . . . . . . #                 # . . . . . . . . . . . . . . . . . #
                                                  # . . . . . . . . . . . . . . . . . . . . . . . #                 # . . . . . . . . . . . . . . . . . #
                                                  # . . # # . . . . . . . . . . . . . . . . . . . #                 # . . . . . . . . . . . . . . . . . #
                                                  # . . # # . . . . . . . . . # # . . . . . . . . #                 # . . . . . . . . . . . . . . . . . #
                                                  # . . . . . . . . . . . . . # # . . . . . . . . # # # # # # # # # # . . . . . . . . . . . . . . . . . #
                                                  # . . . . . . . . . . . . . # # . . . . . . . . . . . . . . . . . . . . . . . . . . . . . . . . . . . #
                                                  # . . . . . . . . . . . . . # # . . . . . . . . . . . . . . . . . . . . . . . . . . . . . . . . . . . #
                                                  # . . . . . . . . . . . . . # # . . . . . . . . . . . . . . . . . . . . . . . . . . . . . . . . . . . #
                                                  # . . . . . . . . . . . . . # # . . . . . . . . . . . . . . . . . . . . . . . . . . . . . . . . . . . #
# # # # # # # # # # # # # # # # # # # # # # # #   # . . . . . . . . . . . . . # # . . . . . . . . # # # # # # # # # # . . . . . . . . . . . . . . . . . #
# . . . . . . . . . . . . . . . . . . . . . . #   # . . . . . . . . . . . . . # # . . . . . . . . #                 # . . . . . . . . . . . . . . . . . #
# . . . . . . . . . . . . . . . . . . . . . . #   # . . # # . . . . . . . . . . . . . . . . . . . #                 # . . . . . . . . . . . . . . . . . #
# . . . . . . . . . . . . . . . . . . . . . . #   # . . # # . . . . . . . . . . . . . . . . . . . #                 # . . . . . . . . . . . . . . . . . #
# . . . . . . . . . . . . . . . . . . . . . . #   # . . . . . . . . . . . . . . . . . . . . . . . #                 # . . . . . . . . . . . . . . . . . #
# . . . . . . . . . . . . . . . . . . . . . . #   # . . . . . . . . . . . . . . . . . . . . . . . #                 # . . . . . . . . . . . . . . . . . #
# . . . . . . . . . . . . . . . . . . . . . . # # # . . . . . . . . . . . . . . . . . . . . . . . #                 # . . . . . . . . . . . . . . . . . #
# . . . . . . . . . . . . . . . . . . . . . . . . . . . . . . . . . . . . . . . # # # # # # # # # #                 # . . . . . . . . . . . . . . . . . #
# . . . . . . . . . . . . . . . . . . . . . . . . . . . . . . . . . . . . . . . # # # # # # # # # #                 # . . . . . . . . . . . . . . . . . #
# . . . . . . . . . . . . . . . . . . . . . . . . . . . . . . . . . . . . . . . . . . . . . . . . #                 # # # # # # # # # # # # # # # # # # #
# . . . . . . . . . . . . . . . . . . . . . . # # # . . . . . . . . . . . . . . . . . . . . . . . #                                                                        
# . . . . . . . . . . . . . . . . . . . . . . #   # . . # # . . . . . . . . . . . . . . . . . . . #                                                                        
# . . . . . . . . . . . . . . . . . . . . . . #   # . . # # . . . . . . . . . . . . . . . . . . . #                                                                        
# . . . . . . . . . . . . . . . . . . . . . . #   # . . . . . . . # # . . . . . . . . . . . . . . #                                                                        
# . . . . . . . . . . . . . . . . . . . . . . #   # . . . . . . . # # . . . . . . . . . . . . . . #                                                                        
# . . . . . . . . . . . . . . . . . . . . . . #   # . . . . . . . # # . . . . . . . . . . . . . . #                                                                        
# # # # # # # # # # # # # # # # # # # # # # # #   # . . . . . . . # # . . . . # # . . . . . . . . # # # # # # # # # # # # # # # # # #                                        
                                                  # . . . . . . . # # . . . . # # . . . . . . . . . . . . . . . . . . . . . . . . . #                                        
                                                  # . . . . . . . # # . . . . . . . . . . . . . . . . . . . . . . . . . . . . . . . #                                        
                                                  # . . . . . . . . . . . . . . . . . . . . . . . . . . . . . . . . . . . . . . . . #                                        
                                                  # . . # # . . . . . . . . . . . . . . . . . . . # # # # # # # # # # # # # # . . . #                                        
                                                  # . . # # . . . . . . . . . . . . . . . . . . . #                         # . . . #                                        
                                                  # . . . . . . . . . . . . . . . . . . . . . . . #                         # . . . #                                        
                                                  # . . . . . . . . . . . . . . . . . . . . . . . #                         # . . . #                                        
                                                  # # # # # # # # # # # # # # # # # # # # # # # # #                         # . . . #                                        
                                                                                                                            # . . . #                                        
                                                                                                                            # . . . #                                        
                                                                                                                            # . . . #                                        
                                                                                                                            # . . . #                                        
                                                                                                                            # . . . #                                        
                                                                                                                            # . . . #                                        
                                                                                                                            # . . . #                                        
                                                                                                                            # . . . #                                        
                                                                                                  # # # # # # # # # # # # # # . . . # # # # # # # # # # # # # #                 
                                                                                                  # . . . . . . . . . . . . . . . . . . . . . . . . . . . . . #                 
                                                                                                  # . . . . . . . . . . . . . . . . . . . . . . . . . . . . . #                 
                                                                                                  # . . . . . . . . . . . . . . . . . . . . . . . . . . . . . #                 
                                                                                                  # . . . . . . . . . . . . . . . . . . . . . . . . . . . . . #                 
                                                                                                  # . . . . . . . . . . . . . . . . . . . . . . . . . . . . . #                 
                                                                                                  # . . . . . . . . . . . . . . . . . . . . . . . . . . . . . #                 
                                                                                                  # . . . . . . . . . . . . . . . . . . . . . . . . . . . . . #                 
                                                                                                  # . . . . . . . . . . . . . . . . . . . . . . . . . . . . . #                 
                                                                                                  # . . . . . . . . . . . . . . . . . . . . . . . . . . . . . #                 
                                                                                                  # . . . . . . . . . . . . . . . . . . . . . . . . . . . . . #                 
                                                                                                  # . . . . . . . . . . . . . . . . . . . . . . . . . . . . . #                 
                                                                                                  # . . . . . . . . . . . . . . . . . . . . . . . . . . . . . #                 
                                                                                                  # . . . . . . . . . . . . . . . . . . . . . . . . . . . . . #                 
                                                                                                  # . . . . . . . . . . . . . . . . . . . . . . . . . . . . . #                 
                                                                                                  # . . . . . . . . . . . . . . . . . . . . . . . . . . . . . #                 
                                                                                                  # # # # # # # # # # # # # # # # # # # # # # # # # # # # # # #                 
                                                                                                                                                                                             
                                                                                                                                                                               
                                                                                                                                                                               
                                                                                                                                                                               
                                                                                                                                                                               
                                                                                                                                                                               
                                                                                                                                                                               
                                                                                                                                                                               
                                                                                                                                                                               
                                                                                                                                                                               
                                                                                                                                                                               
                                                                                                                                                                               
                                                                                                                                                                               
                                                                                                                                                                               
                                                                                                                                                                               
                                                                                                                                                                               
                                                                                                                                                                               
                                                                                                                                                                               