# # # # # # # # # # # # # # # # # # # # # # # # # # # # # # # # # # # # # # # # # # # # # # # #
# . . . . . . . . . . . . . . . . . . . . . . . . . . . . . . . . . . . . . . . . . . . . . . # 
# . . . . . . . . . . . . . . . . . . . . . . . . . . . . . . . . . . . . . . . . . . . . . . # 
# . . # # . . . . . . . . . . . . . . . . . . . . # # . . . . . . . . . . . . . . . . # # . . # 
# . . # # . . . . . . . . . # # . . . . . . . . . # # . . . . . . . . . . . . . . . . # # . . # 
# . . . . . . . . . . . . . # # . . . . . . . . . . . . . . . . . . . . . . . . . . . . . . . # 
# . . . . . . . . . . . . . # # . . . . . . . . . . . . . . . . . . . . . . . . . . . . . . . # 
# . . . . . . . . . . . . . # # . . . . . . . . . . . . . . . . . . . . . . . . . . . . . . . # 
# . . . . . . . . . . . . . # # . . . . . . . . . . . . . . . . # # . . . . . . . . . . . . . # 
# . . . . . . . . . . . . . # # . . . . . . . . . . . . . . . . # # . . . . . . . . . . . . . # 
# . . . . . . . . . . . . . # # . . . . . . . . . . . . . . . . . . . . . . . . . . . . . . . # 
# . . . . . . . . . . . . . # # . . . . . . . . . . . . . . . . . . . . . . . . . . . . . . . # 
# . . # # . . . . . . . . . . . . . . . . . . . . # # . . . . . . . . . . . . . . . . # # . . # 
# . . # # . . . . . . . . . . . . . . . . . . . . # # . . . . . . . . . . . . . . . . # # . . # 
# . . . . . . . . . . . . . . . . . . . . . . . . . . . . . . . . . . . . . . . . . . . . . . # 
# . . . . . . . . . . . . . . . . . . . . . . . . . . . . . . . . . . . . . . . . . . . . . . # 
# . . . . . . . . . . . . . . . . . . . . . . . . . . . . . . . . . . . . . . . . . . . . . . # 
# . . . . . . . . . . . . . # # # # # # # # # # # # # # # # # # # # . . . . . . . . . . . . . # 
# . . . . . . . . . . . . . # # # # # # # # # # # # # # # # # # # # . . . . . . . . . . . . . # 
# . . . . . . . . . . . . . . . . . . . . . . . . . . . . . . . . . . . . . . . . . . . . . . # 
# . . . . . . . . . . . . . . . . . . . . . . . . . . . . . . . . . . . . . . . . . . . . . . # 
# . . # # . . . . . . . . . . . . . . . . . . . . # # . . . . . . . . . . . . . . . . # # . . # 
# . . # # . . . . . . . . . . . . . . . . . . . . # # . . . . . . . . . . . . . . . . # # . . # 
# . . . . . . . # # . . . . . . . . . . . . . . . . . . . . . . . . . . . . . . . . . . . . . # 
# . . . . . . . # # . . . . . . . . . . . . . . . . . . . . . . . . . . . . . . . . . . . . . # 
# . . . . . . . # # . . . . . . . . . . . . . . . . . . . . . . . . . . . . . . . . . . . . . # 
# . . . . . . . # # . . . . # # . . . . . . . . # # # # # # # # # # . . . . . . . . . . . . . # 
# . . . . . . . # # . . . . # # . . . . . . . . # # # # # # # # # # . . . . . . . . . . . . . # 
# . . . . . . . # # . . . . . . . . . . . . . . . . . . . . . . . . . . . . . . . . . . . . . # 
# . . . . . . . . . . . . . . . . . . . . . . . . . . . . . . . . . . . . . . . . . . . . . . # 
# . . # # . . . . . . . . . . . . . . . . . . . . # # . . . . . . . . . . . . . . . . # # . . # 
# . . # # . . . . . . . . . . . . . . . . . . . . # # . . . . . . . . . . . . . . . . # # . . # 
# . . . . . . . . . . . . . . . . . . . . . . . . . . . . . . . . . . . . . . . . . . . . . . # 
# . . . . . . . . . . . . . . . . . . . . . . . . . . . . . . . . . . . . . . . . . . . . . . # 
# # # # # # # # # # # # # # # # # # # # # # # # # # # # # # # # # # # # # # # # # # # # # # # #
