# # # # # # # # # # # # # # # # # # # # # # # # # # # # # #
# . . . . . . . . . . . . . . . . . . . . . . . . . . . . # 
# . . . . . . . . . . . . . . . . . . . . . . . . . . . . # 
# . . # # . . . . . . . . . . . . . . . . . . . . # # . . # 
# . . # # . . . . . . . . . . . . . . . . . . . . # # . . # 
# . . . . . . . . . . . . . . . . . . . . . . . . . . . . # 
# . . . . . . . . . . . . . . . . . . . . . . . . . . . . # 
# . . . . . . . . . . . . . . . . . . . . . . . . . . . . # 
# . . . . . . . . . . . . . b b . . . . . . . . . . . . . # 
# . . . . . . . . . . . . . b b . . . . . . . . . . . . . # 
# . . . . . . . . . . . . . . . . . . . . . . . . . . . . # 
# . . . . . . . . . . . . . . . . . . . . . . . . . . . . # 
# . . # # . . . . . . . . . . . . . . . . . . . . # # . . # 
# . . # # . . . . . . . . . . . . . . . . . . . . # # . . # 
# . . . . . . . . . . . . . . . . . . . . . . . . . . . . # 
# . . . . . . . . . . . . . . . . . . . . . . . . . . . . # 
# # # # # # # # # # # # # # # # # # # # # # # # # # # # # #
