# # # # # # # # # # # # # # # # # # # # # # # 
. . . . . . . . . . . . . . . . . . . . . . b 
. . . . . . . . . . . . . . . . . . . . . . b
. . . . . . . . . b b b b b b . . . . . . . b 
. . . . . . . . . b b b b b b . . . . . . . b 
. . . . . . . . . b b b b b b . . . . . . . b 
. . . . . . . . . b b b b b b . . . . . . . b 
. . . . . . . . . b b b b b b . . . . . . . . 
. . . . . . . . . b b b b b b . . . . . . . . 
. . . . . . . . . b b b b b b . . . . . . . . 
. . . . . . . . . . . . . . . . . . . . . . b 
. . . . . . . . . . . . . . . . . . . . . . b 
. . . . . . . . . . . . . . . . . . . . . . b 
. . . . . . . . . b . . . . . . . . . . . . b 
b b b b b b b b b b b b b b b b b b b b b b b 
# # # # # # # # # # # # # # # # # # # # # # # 

# # # # # # # # # # # # # # # # # # # # # # # # # # # # # # # # 
. . . . . . . . . . . . . . . . . . . . . . . . . . . . . . . b 
. . . . . . . . . . . . . . . . . . . . . . . . . . . . . . . b 
. . . . . . . . . . ` ` ` ` ` ` ` ` b ` ` ` ` ` ` ` . . . . . b 
. . . . . . . . . . ` ` ` ` ` ` ` ` b ` ` ` ` ` ` ` . . . . . b 
. . . . . . . . . . ` ` ` ` ` ` ` ` b ` ` ` ` ` ` ` . . . . . b 
. . . . . . . . . . ` ` ` ` ` ` ` ` b ` ` ` ` ` ` ` . . . . . . 
. . . . . . . . . . ` ` ` ` ` ` ` ` b ` ` ` ` ` ` ` . . . . . . 
. . . . . . . . . . ` ` ` ` ` ` ` ` b ` ` ` ` ` ` ` . . . . . . 
. . . . . . . . . . ` ` ` ` ` ` ` ` b ` ` ` ` ` ` ` . . . . . b 
. . . . . . . . . . ` ` ` ` ` ` ` ` b ` ` ` ` ` ` ` . . . . . b 
. . . . . . . . . . . . . . . . . . . . . . . . . . . . . . . b 
. . . . . . . . . . . . . . . . . . . . . . . . . . . . . . . b 
. . . . . . . . . . . . . . . b . . . . . . . . . . . . . . . b
b b b b b b b b b b b b b b b b b b b b b b b b b b b b b b b b 
# # # # # # # # # # # # # # # # # # # # # # # # # # # # # # # # 

# # # # # # # # # # # # # # # # # # # # # # # 
. . . . . . . . . . . . . . . . . . . . . . b 
. . . . . . . . . . . . . . . . . . . . . . b 
. . . . . . . . . b b b b b b . . . . . . . b 
. . . . . . . . . b b b b b b . . . . . . . b 
. . . . . . . . . b b b b b b . . . . . . . b 
. . . . . . . . . b b b b b b . . . . . . . . 
. . . . . . . . . b b b b b b . . . . . . . . 
. . . . . . . . . b b b b b b . . . . . . . . 
. . . . . . . . . . . . . . . . . . . . . . . 
. . . . . . . . . . . . . . . . . . . . . . b 
. . . . . . . . . . . . . . . . . . . . . . b 
. . . . . . . . . . . . . . . . . . . . . . b 
. . . . . . . . . b . . . . . . . . . . . . b
b b b b b b b b b b b b b b b b b b b b b b b 
# # # # # # # # # # # # # # # # # # # # # # # 

# # # # # # # # # # # # # # # # # # # # # # # 
. . . . . . . . . . . . . . . . . . . . . . b 
. . . . . . . . . . . . . . . . . . . . . . b 
. . . . . . . . . b b b b b b . . . . . . . b 
. . . . . . . . . b b b b b b . . . . . . . b 
. . . . . . . . . b b b b b b . . . . . . . b 
. . . . . . . . . b b b b b b . . . . . . . . 
. . . . . . . . . b b b b b b . . . . . . . . 
. . . . . . . . . b b b b b b . . . . . . . . 
. . . . . . . . . . . . . . . . . . . . . . . 
. . . . . . . . . . . . . . . . . . . . . . b 
. . . . . . . . . . . . . . . . . . . . . . b 
. . . . . . . . . . . . . . . . . . . . . . b 
. . . . . . . . . b . . . . . . . . . . . . b
b b b b b b b b b b b b b b b b b b b b b b b 
# # # # # # # # # # # # # # # # # # # # # # # 

# # # # # # # # # # # # # # # # # # # # # # # 
. . . . . . . . . . . . . . . . . . . . . . b 
. . . . . . . . . . . . . . . . . . . . . . b 
. . . . . . . . . b b b b b b . . . . . . . b 
. . . . . . . . . b b b b b b . . . . . . . b 
. . . . . . . . . b b b b b b . . . . . . . b 
. . . . . . . . . b b b b b b . . . . . . . . 
. . . . . . . . . b b b b b b . . . . . . . . 
. . . . . . . . . b b b b b b . . . . . . . . 
. . . . . . . . . . . . . . . . . . . . . . . 
. . . . . . . . . . . . . . . . . . . . . . b 
. . . . . . . . . . . . . . . . . . . . . . b 
. . . . . . . . . . . . . . . . . . . . . . b 
. . . . . . . . . b . . . . . . . . . . . . b
b b b b b b b b b b b b b b b b b b b b b b b 
# # # # # # # # # # # # # # # # # # # # # # # 

# # # # # # # # # # # # # # # # # # # # # # # 
. . . . . . . . . . . . . . . . . . . . . . b 
. . . . . . . . . . . . . . . . . . . . . . b 
. . . . . . . . . b b b b b b . . . . . . . b 
. . . . . . . . . b b b b b b . . . . . . . b 
. . . . . . . . . b b b b b b . . . . . . . b 
. . . . . . . . . b b b b b b . . . . . . . . 
. . . . . . . . . b b b b b b . . . . . . . . 
. . . . . . . . . b b b b b b . . . . . . . . 
. . . . . . . . . . . . . . . . . . . . . . . 
. . . . . . . . . . . . . . . . . . . . . . b 
. . . . . . . . . . . . . . . . . . . . . . b 
. . . . . . . . . . . . . . . . . . . . . . b 
. . . . . . . . . b . . . . . . . . . . . . b
b b b b b b b b b b b b b b b b b b b b b b b 
# # # # # # # # # # # # # # # # # # # # # # # 

# # # # # # # # # # # # # # # # # # # # # # # 
. . . . . . . . . . . . . . . . . . . . . . b 
. . . . . . . . . . . . . . . . . . . . . . b 
. . . . . . . . . . ` ` ` ` ` ` c ` ` ` . . b 
. . . . . . . . . . ` ` ` ` ` ` c ` ` ` . . b 
. . . . . . . . . . ` ` ` ` ` ` c ` ` ` . . b 
. . . . . . . . . . ` ` ` ` ` ` c ` ` ` . . . 
. . . . . . . . . . ` ` ` ` ` ` c ` ` ` . . . 
. . . . . . . . . . ` ` ` ` ` ` c ` ` ` . . . 
. . . . . . . . . . ` ` ` ` ` ` c ` ` ` . . . 
. . . . . . . . . . ` ` ` ` ` ` c ` ` ` . . b 
. . . . . . . . . . . . . . . . . . . . . . b 
. . . . . . . . . . . . . . . . . . . . . . b 
. . . . . . . . . b . . . . . . . . . . . . b
b b b b b b b b b b b b b b b b b b b b b b b 
# # # # # # # # # # # # # # # # # # # # # # # 

# # # # # # # # # # # # # # # # # # # # # # # 
. . . . . . . . . . . . . . . . . . . . . . b 
. . . . . . . . . . . . . . . . . . . . . . b 
. . . . . . . . . b b b b b b . . . . . . . b 
. . . . . . . . . b b b b b b . . . . . . . b 
. . . . . . . . . b b b b b b . . . . . . . b 
. . . . . . . . . b b b b b b . . . . . . . . 
. . . . . . . . . b b b b b b . . . . . . . . 
. . . . . . . . . b b b b b b . . . . . . . . 
. . . . . . . . . . . . . . . . . . . . . . . 
. . . . . . . . . . . . . . . . . . . . . . b 
. . . . . . . . . . . . . . . . . . . . . . b 
. . . . . . . . . . . . . . . . . . . . . . b 
. . . . . . . . . b . . . . . . . . . . . . b
b b b b b b b b b b b b b b b b b b b b b b b 
# # # # # # # # # # # # # # # # # # # # # # # 

# # # # # # # # # # # # # # # # # # # # # # # 
. . . . . . . . . . . . . . . . . . . . . . b 
. . . . . . . . . . . . . . . . . . . . . . b 
. . . . . . . . . b b b b b b . . . . . . . b 
. . . . . . . . . b b b b b b . . . . . . . b 
. . . . . . . . . b b b b b b . . . . . . . b 
. . . . . . . . . b b b b b b . . . . . . . . 
. . . . . . . . . b b b b b b . . . . . . . . 
. . . . . . . . . b b b b b b . . . . . . . . 
. . . . . . . . . . . . . . . . . . . . . . . 
. . . . . . . . . . . . . . . . . . . . . . b 
. . . . . . . . . . . . . . . . . . . . . . b 
. . . . . . . . . . . . . . . . . . . . . . b 
. . . . . . . . . b . . . . . . . . . . . . b
b b b b b b b b b b b b b b b b b b b b b b b 
# # # # # # # # # # # # # # # # # # # # # # # 

# # # # # # # # # # # # # # # # # # # # # # # 
. . . . . . . . . . . . . . . . . . . . . . b 
. . . . . . . . . . . . . . . . . . . . . . b 
. . . . . . . . . b b b b b b . . . . . . . b 
. . . . . . . . . b b b b b b . . . . . . . b 
. . . . . . . . . b b b b b b . . . . . . . b 
. . . . . . . . . b b b b b b . . . . . . . . 
. . . . . . . . . b b b b b b . . . . . . . . 
. . . . . . . . . b b b b b b . . . . . . . . 
. . . . . . . . . . . . . . . . . . . . . . . 
. . . . . . . . . . . . . . . . . . . . . . b 
. . . . . . . . . . . . . . . . . . . . . . b 
. . . . . . . . . . . . . . . . . . . . . . b 
. . . . . . . . . b . . . . . . . . . . . . b
b b b b b b b b b b b b b b b b b b b b b b b 
# # # # # # # # # # # # # # # # # # # # # # # 

# # # # # # # # # # # # # # # # # # # # # # # 
. . . . . . . . . . . . . . . . . . . . . . b 
. . . . . . . . . . . . . . . . . . . . . . b 
. . . . . . . . . b b b b b b . . . . . . . b 
. . . . . . . . . b b b b b b . . . . . . . b 
. . . . . . . . . b b b b b b . . . . . . . b 
. . . . . . . . . b b b b b b . . . . . . . . 
. . . . . . . . . b b b b b b . . . . . . . . 
. . . . . . . . . b b b b b b . . . . . . . . 
. . . . . . . . . . . . . . . . . . . . . . . 
. . . . . . . . . . . . . . . . . . . . . . b 
. . . . . . . . . . . . . . . . . . . . . . b 
. . . . . . . . . . . . . . . . . . . . . . b 
. . . . . . . . . b . . . . . . . . . . . . b
b b b b b b b b b b b b b b b b b b b b b b b 
# # # # # # # # # # # # # # # # # # # # # # # 

# # # # # # # # # # # # # # # # # # # # # # # 
. . . . . . . . . . . . . . . . . . . . . . b 
. . . . . . . . . . . . . . . . . . . . . . b 
. . . . . . . . . b b b b b b . . . . . . . b 
. . . . . . . . . b b b b b b . . . . . . . b 
. . . . . . . . . b b b b b b . . . . . . . b 
. . . . . . . . . b b b b b b . . . . . . . . 
. . . . . . . . . b b b b b b . . . . . . . . 
. . . . . . . . . b b b b b b . . . . . . . . 
. . . . . . . . . . . . . . . . . . . . . . . 
. . . . . . . . . . . . . . . . . . . . . . b 
. . . . . . . . . . . . . . . . . . . . . . b 
. . . . . . . . . . . . . . . . . . . . . . b 
. . . . . . . . . b . . . . . . . . . . . . b
b b b b b b b b b b b b b b b b b b b b b b b 
# # # # # # # # # # # # # # # # # # # # # # # 

# # # # # # # # # # # # # # # # # # # # # # # 
. . . . . . . . . . . . . . . . . . . . . . b 
. . . . . . . . . . . . . . . . . . . . . . b 
. . . . . . . . . b b b b b b . . . . . . . b 
. . . . . . . . . b b b b b b . . . . . . . b 
. . . . . . . . . b b b b b b . . . . . . . b 
. . . . . . . . . b b b b b b . . . . . . . . 
. . . . . . . . . b b b b b b . . . . . . . . 
. . . . . . . . . b b b b b b . . . . . . . . 
. . . . . . . . . . . . . . . . . . . . . . . 
. . . . . . . . . . . . . . . . . . . . . . b 
. . . . . . . . . . . . . . . . . . . . . . b 
. . . . . . . . . . . . . . . . . . . . . . b 
. . . . . . . . . b . . . . . . . . . . . . b
b b b b b b b b b b b b b b b b b b b b b b b 
# # # # # # # # # # # # # # # # # # # # # # # 

# # # # # # # # # # # # # # # # # # # # # # # 
. . . . . . . . . . . . . . . . . . . . . . b 
. . . . . . . . . . . . . . . . . . . . . . b 
. . . . . . . . . b b b b b b . . . . . . . b 
. . . . . . . . . b b b b b b . . . . . . . b 
. . . . . . . . . b b b b b b . . . . . . . b 
. . . . . . . . . b b b b b b . . . . . . . . 
. . . . . . . . . b b b b b b . . . . . . . . 
. . . . . . . . . b b b b b b . . . . . . . . 
. . . . . . . . . . . . . . . . . . . . . . . 
. . . . . . . . . . . . . . . . . . . . . . b 
. . . . . . . . . . . . . . . . . . . . . . b 
. . . . . . . . . . . . . . . . . . . . . . b 
. . . . . . . . . b . . . . . . . . . . . . b
b b b b b b b b b b b b b b b b b b b b b b b 
# # # # # # # # # # # # # # # # # # # # # # # 

# # # # # # # # # # # # # # # # # # # # # # # 
. . . . . . . . . . . . . . . . . . . . . . b 
. . . . . . . . . . . . . . . . . . . . . . b 
. . . . . . . . . b b b b b b . . . . . . . b 
. . . . . . . . . b b b b b b . . . . . . . b 
. . . . . . . . . b b b b b b . . . . . . . b 
. . . . . . . . . b b b b b b . . . . . . . . 
. . . . . . . . . b b b b b b . . . . . . . . 
. . . . . . . . . b b b b b b . . . . . . . . 
. . . . . . . . . . . . . . . . . . . . . . . 
. . . . . . . . . . . . . . . . . . . . . . b 
. . . . . . . . . . . . . . . . . . . . . . b 
. . . . . . . . . . . . . . . . . . . . . . b 
. . . . . . . . . b . . . . . . . . . . . . b
b b b b b b b b b b b b b b b b b b b b b b b 
# # # # # # # # # # # # # # # # # # # # # # # 

# # # # # # # # # # # # # # # # # # # # # # # 
. . . . . . . . . . . . . . . . . . . . . . b 
. . . . . . . . . . . . . . . . . . . . . . b 
. . . . . . . . . b b b b b b . . . . . . . b 
. . . . . . . . . b b b b b b . . . . . . . b 
. . . . . . . . . b b b b b b . . . . . . . b 
. . . . . . . . . b b b b b b . . . . . . . . 
. . . . . . . . . b b b b b b . . . . . . . . 
. . . . . . . . . b b b b b b . . . . . . . . 
. . . . . . . . . . . . . . . . . . . . . . . 
. . . . . . . . . . . . . . . . . . . . . . b 
. . . . . . . . . . . . . . . . . . . . . . b 
. . . . . . . . . . . . . . . . . . . . . . b 
. . . . . . . . . b . . . . . . . . . . . . b
b b b b b b b b b b b b b b b b b b b b b b b 
# # # # # # # # # # # # # # # # # # # # # # # 

# # # # # # # # # # # # # # # # # # # # # # # 
. . . . . . . . . . . . . . . . . . . . . . b 
. . . . . . . . . . . . . . . . . . . . . . b 
. . . . . . . . . b b b b b b . . . . . . . b 
. . . . . . . . . b b b b b b . . . . . . . b 
. . . . . . . . . b b b b b b . . . . . . . b 
. . . . . . . . . b b b b b b . . . . . . . . 
. . . . . . . . . b b b b b b . . . . . . . . 
. . . . . . . . . b b b b b b . . . . . . . . 
. . . . . . . . . . . . . . . . . . . . . . . 
. . . . . . . . . . . . . . . . . . . . . . b 
. . . . . . . . . . . . . . . . . . . . . . b 
. . . . . . . . . . . . . . . . . . . . . . b 
. . . . . . . . . b . . . . . . . . . . . . b
b b b b b b b b b b b b b b b b b b b b b b b 
# # # # # # # # # # # # # # # # # # # # # # # 

# # # # # # # # # # # # # # # # # # # # # # # 
. . . . . . . . . . . . . . . . . . . . . . b 
. . . . . . . . . . . . . . . . . . . . . . b 
. . . . . . . . . b b b b b b . . . . . . . b 
. . . . . . . . . b b b b b b . . . . . . . b 
. . . . . . . . . b b b b b b . . . . . . . b 
. . . . . . . . . b b b b b b . . . . . . . . 
. . . . . . . . . b b b b b b . . . . . . . . 
. . . . . . . . . b b b b b b . . . . . . . . 
. . . . . . . . . . . . . . . . . . . . . . . 
. . . . . . . . . . . . . . . . . . . . . . b 
. . . . . . . . . . . . . . . . . . . . . . b 
. . . . . . . . . . . . . . . . . . . . . . b 
. . . . . . . . . b . . . . . . . . . . . . b
b b b b b b b b b b b b b b b b b b b b b b b 
# # # # # # # # # # # # # # # # # # # # # # # 

# # # # # # # # # # # # # # # # # # # # # # # 
. c c c c c c c c c c c c c c c c c c c . . b 
. c c c c c c c c c c c c c c c c c c c . . b 
. c c c c c c c c c c c c c c c c c c c . . b 
. c c c c c c c c c c c c c c c c c c c . . b 
. c c c c c c c c c c c . c c c . c c c . . b 
. c c c c c c c c c c c . c c c . c c c . . . 
. c c c c c c c c c c c c c c c c c c c . . . 
. c c c c c c c c c c c . c c c . c c c . . . 
. c c c c c c c c c c c c . . . c c c c . . . 
. c c c c c c c c c c c c c c c c c c c . . b 
. c c c c c c c c c c c c c c c c c c c . . b 
. c c c c c c c c c c c c c c c c c c c . . b 
. c c c c c c c c c c c c c c c c c c c . . b
b b b b b b b b b b b b b b b b b b b b b b b 
# # # # # # # # # # # # # # # # # # # # # # # 

# # # # # # # # # # # # # # # # # # # # # # # 
. . . . . . . . . . . . . . . . . . . . . . b 
. . . . . . . . . . . . . . . . . . . . . . b 
. . . . b b b b b b b b b b b b . . . . . . b 
. . . . b b b b b b b b b b b b . . . . . . b 
. . . . b b b b b b b b b b b b . . . . . . b 
. . . . b b b b b b b b b b b b . . . . . . . 
. . . . b b b b b b b b b b b b . . . . . . . 
. . . . b b b b b b b b b b b b . . . . . . . 
. . . . b b b b b b b b b b b b . . . . . . . 
. . . . b b b b b b b b b b b b . . . . . . b 
. . . . b b b b b b b b b b b b . . . . . . b 
. . . . . . . . . . . . . . . . . . . . . . b 
. . . . . . . . . b . . . . . . . . . . . . b
b b b b b b b b b b b b b b b b b b b b b b b 
# # # # # # # # # # # # # # # # # # # # # # # 

# # # # # # # # # # # # # # # # # # # # # # # 
. . . . . . . . . . . . . . . . . . . . . . b 
. . . . . . . . . . . . . . . . . . . . . . b 
. . . . . . . . . b b ccccccc . . . . . . . b 
. . . . . . . . . b b b b b b . . . . . . . b 
. . . . . . . . . b b b b b b . . . . . . . b 
. . . . . . . . . b b b b b b . . . . . . . . 
. . . . . . . . . b b c c c c c c c c . . . . 
. . . . . . . . . b b b b b b . . . . . . . . 
. . . . . . . . . . . . . . . . . . . . . . . 
. . . . . . . . . . . . . . . . . . . . . . b 
. . . . . . . . . . . . . . . . . . . . . . b 
. . . . . . . . . . . . . . . . . . . . . . b 
. . . . . . . . . b . . . . . . . . . . . . b
b b b b b b b b b b b b b b b b b b b b b b b 
# # # # # # # # # # # # # # # # # # # # # # # 

# # # # # # # # # # # # # # # # # # # # # # # 
. . . . . . . . . . . . . . . . . . . . . . b 
. . . . . . . . . . . . . . . . . . . . . . b 
. . . . . . . . . b b b b b b . . . . . . . b 
. . . . . . . . . b b b b b b . . . . . . . b 
. . . . . . . . . c c c c b b . . . . . . . b 
. . . . . . . . . b b b c b b . . . . . . . . 
. . . . . . . . . b b b c b b . . . . . . . . 
. . . . . . . . . b b b c b b . . . . . . . . 
. . . . . . . . . . . . . . . . . . . . . . . 
. . . . . . . . . . . . . . . . . . . . . . b 
. . . . . . . . . . . . . . . . . . . . . . b 
. . . . . . . . . . . . . . . . . . . . . . b 
. . . . . . . . . b . . . . . . . . . . . . b
b b b b b b b b b b b b b b b b b b b b b b b 
# # # # # # # # # # # # # # # # # # # # # # # 
